######
#   A##
#  #  #
#o  @ #
# @@#o#
###  o#
######